data=data
mydeployment=mydeployment
LoanValidation_ServiceRuleset=mydeployment.LoanValidation_ServiceRuleset
insurance=mydeployment.LoanValidation_ServiceRuleset.out.report.insurance
date=mydeployment.LoanValidation_ServiceRuleset.bankruptcy.date
lastName=mydeployment.LoanValidation_ServiceRuleset.out.report.borrower.lastName,mydeployment.LoanValidation_ServiceRuleset.in.borrower.lastName
zipCode=mydeployment.LoanValidation_ServiceRuleset.in.borrower.zipCode,mydeployment.LoanValidation_ServiceRuleset.out.report.borrower.zipCode
reason=mydeployment.LoanValidation_ServiceRuleset.bankruptcy.reason
chapter=mydeployment.LoanValidation_ServiceRuleset.bankruptcy.chapter
loan=mydeployment.LoanValidation_ServiceRuleset.out.report.loan,mydeployment.LoanValidation_ServiceRuleset.in.loan
monthlyRepayment=mydeployment.LoanValidation_ServiceRuleset.out.report.monthlyRepayment
loanToValue=mydeployment.LoanValidation_ServiceRuleset.out.report.loan.loanToValue,mydeployment.LoanValidation_ServiceRuleset.in.loan.loanToValue
numberOfMonthlyPayments=mydeployment.LoanValidation_ServiceRuleset.out.report.loan.numberOfMonthlyPayments,mydeployment.LoanValidation_ServiceRuleset.in.loan.numberOfMonthlyPayments
SSNCode=mydeployment.LoanValidation_ServiceRuleset.out.report.borrower.SSNCode,mydeployment.LoanValidation_ServiceRuleset.in.borrower.SSNCode
validData=mydeployment.LoanValidation_ServiceRuleset.out.report.validData
yearlyIncome=mydeployment.LoanValidation_ServiceRuleset.out.report.borrower.yearlyIncome,mydeployment.LoanValidation_ServiceRuleset.in.borrower.yearlyIncome
yearlyRepayment=mydeployment.LoanValidation_ServiceRuleset.out.report.yearlyRepayment
spouse=mydeployment.LoanValidation_ServiceRuleset.out.report.borrower.spouse,mydeployment.LoanValidation_ServiceRuleset.in.borrower.spouse
ssn=mydeployment.LoanValidation_ServiceRuleset.out.report.borrower.ssn,mydeployment.LoanValidation_ServiceRuleset.in.borrower.ssn
duration=mydeployment.LoanValidation_ServiceRuleset.out.report.loan.duration,mydeployment.LoanValidation_ServiceRuleset.in.loan.duration
approved=mydeployment.LoanValidation_ServiceRuleset.out.report.approved
latestBankruptcyReason=mydeployment.LoanValidation_ServiceRuleset.out.report.borrower.latestBankruptcyReason,mydeployment.LoanValidation_ServiceRuleset.in.borrower.latestBankruptcyReason
yearlyInterestRate=mydeployment.LoanValidation_ServiceRuleset.out.report.yearlyInterestRate
insuranceRequired=mydeployment.LoanValidation_ServiceRuleset.out.report.insuranceRequired
latestBankruptcyDate=mydeployment.LoanValidation_ServiceRuleset.out.report.borrower.latestBankruptcyDate,mydeployment.LoanValidation_ServiceRuleset.in.borrower.latestBankruptcyDate
fullNumber=mydeployment.LoanValidation_ServiceRuleset.in.borrower.ssn.fullNumber,mydeployment.LoanValidation_ServiceRuleset.out.report.borrower.ssn.fullNumber
groupCode=mydeployment.LoanValidation_ServiceRuleset.in.borrower.ssn.groupCode,mydeployment.LoanValidation_ServiceRuleset.out.report.borrower.ssn.groupCode
creditScore=mydeployment.LoanValidation_ServiceRuleset.out.report.borrower.creditScore,mydeployment.LoanValidation_ServiceRuleset.in.borrower.creditScore
amount=mydeployment.LoanValidation_ServiceRuleset.out.report.loan.amount,mydeployment.LoanValidation_ServiceRuleset.in.loan.amount
serialNumber=mydeployment.LoanValidation_ServiceRuleset.in.borrower.ssn.serialNumber,mydeployment.LoanValidation_ServiceRuleset.out.report.borrower.ssn.serialNumber
insuranceRate=mydeployment.LoanValidation_ServiceRuleset.out.report.insuranceRate
borrower=mydeployment.LoanValidation_ServiceRuleset.in.borrower,mydeployment.LoanValidation_ServiceRuleset.out.report.borrower
areaNumber=mydeployment.LoanValidation_ServiceRuleset.out.report.borrower.ssn.areaNumber,mydeployment.LoanValidation_ServiceRuleset.in.borrower.ssn.areaNumber
message=mydeployment.LoanValidation_ServiceRuleset.out.report.message
birthDate=mydeployment.LoanValidation_ServiceRuleset.out.report.borrower.birthDate,mydeployment.LoanValidation_ServiceRuleset.in.borrower.birthDate
firstName=mydeployment.LoanValidation_ServiceRuleset.in.borrower.firstName,mydeployment.LoanValidation_ServiceRuleset.out.report.borrower.firstName
latestBankruptcyChapter=mydeployment.LoanValidation_ServiceRuleset.out.report.borrower.latestBankruptcyChapter,mydeployment.LoanValidation_ServiceRuleset.in.borrower.latestBankruptcyChapter
report=mydeployment.LoanValidation_ServiceRuleset.out.report
messages=mydeployment.LoanValidation_ServiceRuleset.out.report.messages
digits=mydeployment.LoanValidation_ServiceRuleset.out.report.borrower.ssn.digits,mydeployment.LoanValidation_ServiceRuleset.in.borrower.ssn.digits
age=mydeployment.LoanValidation_ServiceRuleset.in.borrower.age,mydeployment.LoanValidation_ServiceRuleset.out.report.borrower.age
startDate=mydeployment.LoanValidation_ServiceRuleset.out.report.loan.startDate,mydeployment.LoanValidation_ServiceRuleset.in.loan.startDate
